--------------------------------------------------------------------------------------------------------------------------------------------------------------------------------------------------------
--------------------------------------------------------------------------------------------------------------------------------------------------------------------------------------------------------
--------------------------------------------------------------------------------------------------------------------------------------------------------------------------------------------------------
-------------------------------------------M----------------------------B--------------------o--------------------B-----------------o-o---------------------Bo-X------oX------------------------------?-
-----------------X-----------------------------------------------------------------o------------------------------------------------------------B-B-----------------X-------M-------------------B-------
--------B-?----------------------------------------B---o----------------------------------------------X--o-----B--------------------------------------------------------------------------------o--B----
---------------------------BBBBB-------------------------------------o----------------------------o-?---------------M---------------------M---------------------------------------BBBB--B---------------
--------X-------------------------------X--------------------------X-----------------B--M----------------?-----X--------X------------------------------------------------------?-----------------------v
--------------X------o-----------------------------------------------------------------------------------------M-------B-XBBBBB---------X-------------XXXXXX--------??B???------?------B-----o---------f
-------BM-BBBBBBB---------------------------------o----------------------?-----T--------------------------B----------------------?------M-------------------------------------o------------------------f
-----------------------------XBBBBBBM---------------------X-----------T--------|-----------X----oB-----------------??????----------------------------------------o-----------------o---M---------------f
----------X----XXXX------------------?T?----X-------------XX----------|-------T|-X---------XX-T----------------------------------------------------------XXXXXXX---------------------------------------f
---------XX---------------------------|X----XX------------XXX------T--|T------||?XX--------XXX|--------------???????---------------T-------------X------T-------------------XXXXXX----------------T----f
--------XXX--------------------------X|X----XXX-----X-----XXXX-----|--||-----T||-XXX-------XXXX------------------------------------|-------------XX-----|--------T--------------------------------|----f
m------XXEE---------X-----E---------XXXX----XXXX----XXEX--XXXXX----|--||----E|||-XXXX----E-XXXXX-----XE-------E------E---E---E--E-E|-----E-----X-XXX-E--|-------E|-------------------E----E--E----|E--EX
XX-XXXXXX---XXXXXXXXXXXXXXXXXXXXX--XXXXXX--XXXXXXXXXXXXXXXXXXXXXX-X|XX||XXXXX|||-XXXXXXXXXXXXXXXXXXXX-XXXXXXXXX--XXXXXXXXX---XXXXXX|XXXXXX-XXXX--XXXX---|XXX----X|XXXXXXXXXXXXXXXX--XXXXXXX--XXXXX|XXX-X
