--------------------------------------------------------------------------------------------------------------------------------------------------------------------------------------------------------
--------------------------------------------------------------------------------------------------------------------------------------------------------------------------------------------------------
--------------------------------------------------------------------------------------------------------------------------------------------------------------------------------------------------------
---------------o-----------------o---o-----------------------B------o------------------------o---------B--------------------------------------------------X--------------X---------------------------o--
----------------------M------------------------------------------------------------o------------------o------?-------------------------------------------------o----X-----------------------------------
------------------------------------XXX---BBBBBB--------------------------------XXX----------------------------B---------------X----------------------------------------X-------------------------------
----------M------------------------------------M--X---------------?--o---o----------------X--o------M---------------M----------------?----M-----------------------------------B---------B-----------?XX-
-------------------------------------------------------------M----XX--M----------????------XXX---------oo?----------B-----------BXBM---------------XXX-------?-?----------o--------XXXXXX-------------Mv
-------------------------------------------------------------o------o----------M---------------------B-X-----------------X------X------B---------------o-----------------------------------------------f
----------------------------------o--------------------T--------------B------------XXXXoXX----------------B----MBBBB?B---------X--------o---------------------X----------------------X-----------------f
------XXXXXXX----------------------------------------o-|-X---X--------XXXXXXX--X----------------o-----------------------------------------------o----------------BBBBBBB--------------o--------------BBf
-----------------T-------------------------------------|----XX--------X-------BBBBBB--------X---------------------T--T------------------------T------------------------------------T-------------------f
-----------------|---------------X---------------------|---XXX--------XX-----------------X--XX----------XXXXX-----|--|-------------T----------|------------------------------------|--------------T----f
-----------------|--------------XX-------------------X-|--XXXX--------XXX----T----------XX--XXX----------XX-------|--|-------------|----------|---------X--------------------------|----T---------|----f
m--------E----E--|-EE----------XXX-----------E---EE-XX-|-XXXXXE---X-E-XXXX---|-------E-XXE-EXXXX--------XXXX--E-E-|--|-----------X-|-XE--E---E|E--E----XX-------E------------------|----|-E-------|----X
XXXXXXXXXXXXXXXXX|---XXXXXXXXXXXXXXXX-XXXXXXXXXXXXXXX--|XXX----XX-XXXXXXXXXXX|XX-----XXXXXX-XXXXXX---XXXXXXXXXXXXX|XX|XX---XX-XXXXX|XX----XXXX|XXXXXXXXXXXXXXX----XXX---XXXXXXXXXXX|X---|XX--XXXXX|XXX-X
