--------------------------------------------------------------------------------------------------------------------------------------------------------------------------------------------------------
--------------------------------------------------------------------------------------------------------------------------------------------------------------------------------------------------------
--------------------------------------------------------------------------------------------------------------------------------------------------------------------------------------------------------
-----o-----------------------------------------------------------------------B--------------------?-----------------------------X-------------------------X--------------X----------------------B----o?-
---------------------------B-------------B------------o------------------------------------------------------?-----------------------------B------B------------o----X-----------------------------------
----------------------------BBBBXXXXX--------X-----o--------M----------------------------o------------X--o-----B---------B-----X---?------M-----------------------------X-----------------------o-------
----------------------------------------M----------------------------X-----------------------o------M---------------M----------------------------X----------------------------B---------B-----------?XX-
----------------B----------B-------------------------o-------------X-----------------------XXX-----------?----------B-----------BXBM---------?---------------?-?------X---o----?----------------------Mv
-----?B----------------------------?????------------XXXXX------------XXXXXXX---------------------------X------o----------X?-----X------B-----------------------------------------------B-----o---------f
----B-----------------------------------M--------------M--------?M---------B-----------------M-----------------M----?-----BBBB-X-?------o---------------------X----------------------X----B----X----M--f
--------------------------------------------------MX-----X-o-------------------X-------------BBBBBBB---------X--------?-------------------------o----------------BBBBBTB--------------o--------------BBf
----------------X--------------------------------------?????---------T----------------------X------BBBB-----XX------T-------------------------T---------------XXX-----|-----------XT-------------------f
----------------XX-------------------------------------XXX-----BBBB-X|----------------------XXT------------XXX------|--------------T----------|---X-------------------|----------XX|--------------T----f
----------------XXX-----------------------------------XXXX-T-------XX|---X---T--------------XXX-----------XXXX------|--------------|----------|---XX----X-------------|---------XXX|----T---------|----f
m---------------XXXX----------E---EEE----EE----X----EXXXXX-|--E---XXX|---XX-EX------EE-----EXXXX--E-E-E-XXXXXXE-E---|-------E------|-XE--E----|EE-XXXE-XX-------E-----|--------XXXX|---E|-E-------|E---X
XXXXXXXX---XXXXXXXXXXXXXXXX--X----XXXXXXXXXXXXXXXXXXXXXXXXX|XXXXXXXXX|XXXXXXXXXXXX--------X-XXXXX-XXX--XXXXXXXXXXX--|-XX---XX-XXXXX|XX----XX-X|XXXXXXXXXXX--XX----XXX-|-XXXXXXXXXXX|X---|XX---XXXX|XXX-X
