--------------------------------------------------------------------------------------------------------------------------------------------------------------------------------------------------------
--------------------------------------------------------------------------------------------------------------------------------------------------------------------------------------------------------
--------------------------------------------------------------------------------------------------------------------------------------------------------------------------------------------------------
-------------------------------------------M-------------------------------------------------------------------------------------------------------------------X-------------------------------------o--
-------------------------------------------------------------------------------------------o-------------------------------------------------------------------o----X-----------------------------------
--------B------------------------------------------------------------------------X---------------------------------------------X------------------------------------------------------------------------
---------------------------BBBBB-------------------------------------------------------------o----o-?-------------------------------------M---------------------------X----B-----------------???--------
--------X-------------------------------X-------------------------------o---------------M--XXX----------o------------------------X---------------------------?-?---------------------------------------v
--------------X-----------------------------------------------------------X--B--------------------------------------------BBBBB---------------------------X--------------------------------------------f
-------B------------------------------------------o----------------------------T-------------------------------BBBBB?B---------B--------o--------------------------------------------------------------f
------------------------------------M---------------------X-----------T--------|----------------------------------------------------------------o-------------------------------------o----------------f
---------------XXXX-------------------TX------------------XX----------|--------|-XT--------------------------------------------------------------------------------------------------------------------f
--------------------------------------|X------------------XXX-----X---|-------T|?XX------------------------------------------------T--------------------T----------------T------------------------T----f
-------------------------------------X|X------------X-----XXXX----XX--|------T||-XXX-----------------------------------------------|--------------------|----------------|--------------T---------|----f
m---------E---------------E---------XXXX------------XXEX--XXXXX---XXX-|-----E|||-XXXXE-------------E----X-----E-E----E-------E-----|EXE--E--------------|-------E-E------|-----------E--|-E-------|---EX
XXXXXXXXX---XXXXXXXXXXXXXXXXXXXXX--XXXXXXXXX--XXXXXXXXXXXXXXXXXXXXXXXX|XXXXXX|||XXXXXXXXXXX-----XXXXXXXXXXXXXXXXXXXXXXXX--XXXXXXXXX|XX-----XXXXXXXXXXXXX|XXXXX----XXX---X|XXXXXXXXXXXXXX|XX--XXXXX|XXX-X
