--------------------------------------------------------------------------------------------------------------------------------------------------------------------------------------------------------
--------------------------------------------------------------------------------------------------------------------------------------------------------------------------------------------------------
--------------------------------------------------------------------------------------------------------------------------------------------------------------------------------------------------------
-------?-----?----------M-----------------------------B----------------------------------------------------------------------------------------------------------------------------------------------o--
----------------------M-M-----------------------------------B----------------------------------------------------?----------------B----------------------------o----X-----------------------------------
----------------X--------------------o-----------------------------------------------------------------------------------------X------------------------------------------------------------------------
--------------------------------???--------------------------------M-------BBB------?????--------------------?----------------------------M----------------------------------?--------------------------
------------o-------o----------------------------------------------------------------------XXX----------o------------------------X------------------????-----?-?---------------------------------------v
---------------------------------------------?--------------------------------------------------------------BBBBBB-------------------------?-----------------------------------------------------------f
--------------------------------------?X-----------------------------TXXX-------------o------------------------BBBBB?B---------X--------o-BBBBB--------------------------------------------------------f
---------------X-----------------------------------Xo-----B----------|-------------?----?---------o-----M---------------------------------------o-------------------------------------o----------------f
---------------------------X---------------X------XX-----------------|---------------X-----------------------------------------------------------------------------------------------------------------f
-------------------T-----------------------XX----XXX------------???--|X--------------XX------------T------------------?????BBBBB---T--------------------------------------------------------------T----f
-------------------|-----------------------XXX--XXXX-----------------|XX-------------XXX-----------|-------------------------------|----------------------------------------------------T---------|----f
m-----------------E|E-----E--E-----E-E-----XXXXXXXXX-XE-------------X|XXX------------XXXX----------|----X-------------------E------|-XE--E-----------------E----E-E---------------------|-E-------|----X
XXXXXXXXXXXXXXXXXXX|XXXXXXXXXXXXXX-XXXXXX--XXXXXXXXXXXXXXXXXXXXXXXXXX|XXXXXXXXXXXXXXXXXXXXX-XXXXXXX|XXXXXXXXX----XXXXXXX--XXXXXXXXX|XX----XXXXXXXXX--XXXXXXXXX----XXX---XXXXXXXXXXXXXXXX|XX--XXXXX|XXX-X
