--------------------------------------------------------------------------------------------------------------------------------------------------------------------------------------------------------
--------------------------------------------------------------------------------------------------------------------------------------------------------------------------------------------------------
--------------------------------------------------------------------------------------------------------------------------------------------------------------------------------------------------------
----------B-------------BX----------------------------o----------------------B-----------M--------------------------------------X-------------------------o---------------------M--------------------o--
-----------------------------------------------------?o-------------------M--------X--------------------------------o-----------------------------o--o---------o----X----X--X---------------------------
-----X-X--------------------BBBBBB-----------------o----oX-------------------------------o-----?----------o------------o-----------?------XX?????---------M----o-------??????M------------------o-------
----------------------------------------M---------B-----------------?--------?--------------------------------------------BBBBB-----------M---------------------------o---------o-----------------------
--o------------------------B-------------------------o--------------------------o----------XXX----------o-----------oB-----------X--------------?------------?-?-----------B---------------BBB-----?---v
-----?------------------?--------------------------------------XXXXoXXXXXXXX------M----o---------????B--------o----o---------------------------------------M----------------------????-----------------f
---------------------------o---------------------------M-------------B-o---------------------T-----------------BBBBBBB---------X------BBo----------------------------------------BBB-X-----------------f
------------?---------------------o---------------------------------------------------------B|-----X---------X--------X-------------------------o--T----------------------------------o----------------f
-------------------------------------------------------?????---------T--------------------T--|-----BBBBX----XXT-------XX---T-----------------------|----X----------X-----------------------------------f
----------------------X----------------------------------------BBBB-X|--------------------|--|T--BBB--XXX--XXX|-------XXX--|---BBBBT---------------|----XX------T-XX-----------XXXXX-T-----X------T----f
----------------------XX-------------------------------------------XX|--------T-----X----X|--||-----XXXXXXXXXX|-------XXXX-|-------|---------------|----XXX-----|XXX-----------------|--T--XX-----|----f
m--------EE------E----XXX-------------X--E-----E----E-------------XXX|--------|-E--XXE--EXX--||-----XXXXXXXXXX|-E-----XXXXX|---X---|-X---E------E--|EE--XXXX----|XEX----EE---------X-|--|-EXXX--E-|---EX
XXXXXXXXXXXXXXXXXXXXXXXXXXXXXXXXXXX--XXXXXXXXXXXXXX-XXXXXXX------XXXX|XXXXXXXX|XXXXXX----XXXX||XXXXXXXXXXXXXXX|XXXXXXXXXXXX|X-XXXXX|XX----XX-XXXX--|-XXXXXXXXX-X|XXXX---XXXX-XXXXXXXX|XX|XXXXXXXXX|XXX-X
