--------------------------------------------------------------------------------------------------------------------------------------------------------------------------------------------------------
--------------------------------------------------------------------------------------------------------------------------------------------------------------------------------------------------------
--------------------------------------------------------------------------------------------------------------------------------------------------------------------------------------------------------
-----------------------------------------------------------------------?-----B----------------M---------------------------------X--------------------------------------------------------------------o--
---------------------------------------------------------------------------------------------------B----------------o------------------------------------------o----X--------------------o--------------
---------------------------------------------------o-------------------------------------o-----------------------------------------?-----------------------?-------------------------------------o------
----------------------------------------M--------------------------M-------BBB-----------------------------?------------?-----------------M-------------------------------------------------------------
------------o-X-B----------B-------B-----------------o---------?????-----------------------XXX----------o------------------------X----------------o----------?-?----------M----------------------------v
---------------------------------------------?-----------------------XXXXXXBBBBBBB-X--------------------------o-----------?-----------------------XXXXX--------------------------------B-----o---------f
--------------------------------------?X---------------M-------------?---------------????----------------------B??????--??????-X--------o----?-------------------B-------------------------------------f
-----o-------------T--------XXXXXXX----------------X-----T-----------------------T------?-------------??M?---Xo------------------------------o--o---X---------------------------------o----------------f
--------T------X---|------------------------------XX-----|-----------T-----------|---X---X------------------XX-----------------------------------------------------------------------------------------f
--------|-----XX---|-----------------------------XXX-----|----------X|X----------|---XX--XX----------------XXX--------?????BBBBB---T----------------------------------------T---------------------T----f
--------|----XXX---|-----------------------X----XXXX-----|---------XX|XX---------|---XXX-XXX--T----T------XXXX---------------------|----------------------------------------|-----------T---------|----f
m-------|---XXXX---|E-E-E-E----------------XX--XXXXXEX---|-----E--XXX|XXX--E--E--|---XXXXXXXX-|----|----XXEXXX--E------------------|-X---E----EXE----EX---------E-E---------|-----------|-E----E--|----X
XXXXXXXX|-XXXXXXX-X|XXX--XXXXXX----XXXXXX--XXXXXXXX-XXXXX|X----XXXXXX|XXXXXXXXXXX|---XXXXXXXXX|XXXX|XXXXXXXXXXXXXXXXXXXX-XXXXXXXXXX|XX----XX-XXXXXXXXXXXXXXXXX----XXX---XXXX|XX---XXXXXX|XX--XXXXX|XXX-X
