--------------------------------------------------------------------------------------------------------------------------------------------------------------------------------------------------------
--------------------------------------------------------------------------------------------------------------------------------------------------------------------------------------------------------
--------------------------------------------------------------------------------------------------------------------------------------------------------------------------------------------------------
----------B-------------B----------------------------------------------------------------M----------------------------------------------------------------------------o---------M-----------------------
-------------------------------------X--M-------------o-------------------M--o-----B--------------------------------------------------------------------------------X-----------------------------------
----------------------------BBBBBX------------------------------------------------X-------------------------B-------------------------------------------------------------------------------------------
------o---??????-----------------------------------------------o------------------------------------?----------------------BBBB----------BM------o------------------------------------------------------
----------------------------B---------------------------------------------------o----------------------------------------------------------------------------------------------------------------------v
----------------------XX?---------------o---------------o----?---------------------------------------B-------------o-----------------B--o-----------------X---------??????--------????-----------------f
---------------------------M------------------------X----------------------------------X------------------------------------------------M-----T------------------------XXXXXXX-------------------------f
------------?-----------------------T-------------------------------------------------------B------------X------------------------------------|------------------------------------o---M---------------f
------------------------------------|----T-------------XXXXX-----------------T---------------------BBBB-XX------------------------------------|---------------XXX-----------------X--------------------f
----------------------X--X----------|----|---------------------BBBB----------|--------T---BBBBB--------XXX----------???????--------T----------|---X-----T------------------------XX---------------T----f
----------------------XX-XX---------T----|---------X----X--------------------|--------|-------------X-XXXX---------------------T---|----------|--XX-----|-----------------------XXX---------------|----f
m--------E-------E----XXXXXX--------|----|-----X-EXXX---XXE------------------|----E-EE|-E-----------XXXXXX--E------------------|---|----------|-XXX-----|-------E--------------XXXX--E----E-------|---EX
XXXXXXXXXXXXXXXXXXXXXXXXXXXXXXXXXXXX|XXXX|XXXXXXXXXXXXXXXXX--XXXXXXXXXXXXXXXX|XXXXXXXX|XXXXXXXXXXXXXXXXXXXXXXXXXXXXXXXXXXX----X|XXX|XXXXXX-XX-|XXXXXXXXX|XXXXXXXXXXXXXXXXXXXXXXXXXXXXXXXXXX--XXXXX|XXX-X
