--------------------------------------------------------------------------------------------------------------------------------------------------------------------------------------------------------
-----------------------------------------------------------------------------------------------------------------------------------------------------------------------B--------------------------------
-----------------------------------------------------------------------XXXXXX----------------------------------------------------------------o-----------?----------------------------------------------
--------------------------------------------------------------------------------------------------------------------------------------------------------------o-----------------------------------------
------o--------------------------------X----------------------------------------------------------------------------o-----------------------------------------------------------------------------T-----
--------------------------------------XX----------------------------------------------------------------------------------------------------------------------------------------------------------|-----
-------------------------------------XXX---------------------------------------------------------M--------------------------------------------------------------------------------------------X---|-----
------------------------------------XXXX---------------------------------------------------?--------------------------------------------------------------------------------???--------------XX---|----v
-----------------------------------XXXXX------------X---------------------------------------------------------------------------------------------------------------------------------------XXX---|----f
--------------------------X----T--XXXXXX-----------XX--------------------------------------------------------------------------------------------------------------------------------------XXXX---|----f
-------------------------------|-XXXXXXX----------XXX-----------------------------------------------------------------M-------------------------------------------------X-----------------XXXXX---|----f
-------------------------------|XXXXXXXX---------XXXX------------------T-----------------------------------------------------------XXXXXX------XXXXXXT--------------------X--------------XXXXXX---|----f
-------------------------------|XXXXXXXX--------XXXXX------------------|-------------???-----------------------X---------------------?XXXXXXX--------|--------------------XX------------XXXXXXX---|----f
--------------T---------------X|XXXXXXXX----?--XXXXXX------------------|---------------------------------------XX------------------------------------|--------------------XXX----------XXXXXXXX---|----f
m-------XXXXXX|X-------------XX|XXXXXXXX------XXXXXXX------------------|------------E------------------------E-XXX-----E------------E---------E------|------------------E-XXXX--------XXXXXXXXX---|----X
XXXXXXXXXXXXXX|XXXXXXXXXXXXXXXX|XXXXXXXXXXXXXXXXXXXXXX------XXXXXXXXXXX|XXXXXXXXXXXXXXXXXXXXXXXXXXXX--------XXXXXXXXXXXXXXXXXXXXXXXXXXXXoXXXXXXXXXXXX|XXXXXXXXXXXXXXXXXXXXXXXXXXXXXXXXXXXXXXXXXXXX|XXXXX
